7 8
#######
#.....#
#..o..#
#.....#
#######
#.....#
#..*..#
#######